111111111111111
1100000C1001101
10000000C000001
1C00000110C0001
1C0000000000001
1C0000E000C0001
111111111111111