111111111111111
1100000C10011E1
10000000C000101
1C00000110C0101
1C00000000P0101
1C00000000C0101
111111101111111