111111111111111
1100000C10011E1
10000000C000001
1C00000110C0001
1C00000000P00011
1C00000000C0001
111111111111111