111111111111111
1100000C10011E1
10000000C000001
1C00000110C0001
1C0000000000111
1C00000000C01P1
111111111111111